7 7
#..####
#A..###
###...#
....#.#
.####.#
#.B...#
#######