7 6
######
A..###
##...#
#..#.#
#.##.#
#B...#
######