7 7
#######
#..####
###..##
##..#.#
##.##.#
###.###
#######
